-2 -3 -3 -4 -4 -2 -4 -4 -3 -3 -4 -5
-1 1 1 1 1 1 1 1 1 1 1 -1
-1 1 1 -5 1 -5 1 1 1 1 1 -1
-1 1 1 1 1 1 -5 1 1 1 1 -1
-1 1 1 1 1 1 1 1 1 1 1 -1
-1 1 1 1 1 1 1 1 1 1 1 -1
-1 1 1 1 1 1 1 1 1 1 1 -1
-1 1 1 1 1 1 1 1 1 1 1 -1
-1 1 1 1 1 1 1 1 1 1 1 -1
-1 1 1 1 1 1 1 1 1 1 1 -1
-1 1 1 1 1 1 1 1 1 1 1 -1
-1 -1 -1 -1 -1 -1 -1 -1 -1 -1 -1 -1