-2 -3 -3 -4 -4 -2 -4 -4 -3 -4 -2 -3 -3 -4 -2
-1 00 45 01 02 03 04 05 06 90 91 92 93 94 -1
-1 07 44 -5 69 -5 09 10 11 96 97 98 99 100 -1
-1 12 13 14 60 15 -5 16 17 81 82 83 84 101 -1
-1 18 19 46 61 62 63 20 21 85 86 87 88 102 -1
-1 22 -5 47 23 24 25 26 27 89 70 71 72 103 -1
-1 28 29 48 30 66 64 65 31 73 74 75 76 104 112 -1
-1 32 33 49 50 51 34 111 35 77 78 67 68 105 -1
-1 36 37 38 39 40 41 42 43 106 107 108 109 110 -1
-1 -1 -1 -1 -1 -1 -1 -1 -1 -1 -1 -1 -1 -1 -1